		11111111111111111111111111
		10000000000110000000000001
		10110000001110000000000001
		10010000000000000000000001
1111111110110000001110000000000001
1000000000110000001110111111111111
111101111111111011100000010001
111101111111111011101010010001
110000000110101011100000010001
100000000000000011100000010001
100000000000000001100000010001
100000000000000001101010010001
110000011101010111111011110N0111
11110111 11101011 101111010001
11111111 11111111 111111111111